11
16
22

0 0 0 0 0 0 0 0 0 0 0 
0 0 0 0 0 0 0 0 0 0 0 
0 0 0 0 0 0 0 0 0 0 0 
0 0 0 0 0 0 0 0 0 0 0 
0 0 0 0 0 0 0 0 0 0 0 
0 0 0 0 0 0 0 0 0 0 0 
0 0 0 1 1 1 1 1 1 1 0 
0 0 0 1 1 1 1 1 1 1 0 
0 0 0 1 1 1 1 1 1 1 0 
0 0 0 1 1 1 1 1 1 1 0 
0 0 0 1 1 1 1 1 1 1 0 
0 0 0 1 1 1 1 1 1 1 0 
0 0 0 1 1 1 1 1 1 1 0 
0 0 0 0 0 0 0 0 0 0 0 
0 0 0 0 0 0 0 0 0 0 0 
0 0 0 0 0 0 0 0 0 0 0 

0 0 0 0 0 0 0 0 0 0 0 
0 0 0 0 0 0 0 0 0 0 0 
0 0 0 0 0 0 0 0 0 0 0 
0 0 0 0 0 0 0 0 0 0 0 
0 0 0 0 0 0 0 0 0 0 0 
0 0 0 0 0 0 0 0 0 0 0 
0 0 0 1 1 1 1 1 1 1 0 
0 0 0 0 0 0 0 0 0 0 0 
0 0 0 0 0 0 0 0 0 0 0 
0 0 0 0 0 0 0 0 0 0 0 
0 0 0 0 0 1 10 1 0 0 0 
0 0 0 0 0 0 0 0 0 0 0 
0 0 0 0 1 1 1 1 1 1 0 
0 0 0 0 0 0 0 0 0 0 0 
0 0 0 0 0 0 0 0 0 0 0 
0 0 0 0 0 0 0 0 0 0 0 

0 0 0 0 0 0 0 0 0 0 0 
0 0 0 0 0 0 0 0 0 0 0 
0 0 0 0 0 0 0 0 0 0 0 
0 0 0 0 0 0 0 0 0 0 0 
0 0 0 0 0 0 0 0 0 0 0 
0 0 0 0 0 0 0 0 0 0 0 
0 0 0 0 0 0 0 0 0 0 0 
0 0 0 0 0 0 0 0 0 0 0 
0 0 0 0 0 0 0 0 0 0 0 
0 0 0 0 0 0 0 0 0 0 0 
0 0 0 0 0 1 1 1 0 0 0 
0 0 0 0 0 0 0 0 0 0 0 
0 0 0 0 0 0 1 0 0 0 0 
0 0 0 0 0 0 0 0 0 0 0 
0 0 0 0 0 0 0 0 0 0 0 
0 0 0 0 0 0 0 0 0 0 0 

0 0 0 0 0 0 0 0 0 0 0 
0 0 0 0 0 0 0 0 0 0 0 
0 0 0 0 0 0 0 0 0 0 0 
0 0 0 0 0 0 0 0 0 0 0 
0 0 0 0 0 0 0 0 0 0 0 
0 0 0 0 0 0 0 0 0 0 0 
0 0 0 0 0 0 0 0 0 0 1 
0 0 0 0 0 0 0 0 0 0 0 
0 0 0 0 0 0 0 0 0 0 0 
0 0 0 0 0 0 0 0 0 0 0 
0 0 0 1 1 1 1 1 0 0 0 
0 0 0 0 0 0 0 0 0 0 0 
0 0 0 0 0 0 1 0 0 0 0 
0 0 0 0 0 0 0 0 0 0 0 
0 0 0 0 0 0 0 0 0 0 0 
0 0 0 0 0 0 0 0 0 0 0 

0 0 0 1 1 1 1 1 1 1 0 
0 0 0 1 1 1 1 1 1 1 0 
0 0 0 1 1 1 1 1 1 1 0 
0 0 0 1 1 1 1 1 1 1 0 
0 0 1 1 1 1 1 1 1 1 1 
0 0 0 1 1 1 1 1 1 1 0 
0 0 0 1 1 1 1 1 1 1 1 
0 0 0 1 1 1 1 1 1 1 0 
1 1 0 1 1 1 1 1 1 1 0 
0 0 0 1 1 1 0 1 1 1 0 
0 0 0 1 1 1 10 1 1 1 0 
0 0 0 1 1 1 0 1 1 1 0 
0 0 0 1 1 1 1 1 1 1 0 
0 0 0 1 1 1 1 1 1 1 0 
0 0 0 1 1 1 1 1 1 1 0 
0 0 0 1 1 1 1 1 1 1 0 

0 0 0 1 1 1 1 1 1 1 0 
0 0 0 1 0 0 0 0 0 1 0 
0 0 0 1 0 0 0 0 0 1 0 
0 0 0 0 0 0 0 0 0 1 0 
0 0 1 1 1 1 10 1 1 1 1 
0 0 0 1 1 1 0 0 1 0 0 
0 0 0 1 1 1 0 0 1 1 1 
0 0 0 1 1 1 1 0 1 1 0 
0 0 0 1 1 1 1 0 1 1 0 
0 0 0 1 1 1 1 0 1 1 0 
0 0 0 1 1 1 1 0 1 1 0 
0 0 0 1 1 1 0 0 1 1 0 
0 0 0 1 1 1 1 0 1 1 0 
0 0 0 1 1 1 1 0 1 1 0 
0 0 0 1 1 1 1 0 1 1 0 
0 0 0 1 1 1 1 0 1 1 0 

0 0 0 1 1 1 1 1 1 1 0 
0 0 0 1 1 0 0 0 0 1 0 
0 0 0 1 1 0 0 0 0 1 0 
0 0 0 1 1 0 0 0 0 1 0 
0 0 1 1 1 1 1 1 1 1 1 
0 0 0 1 1 1 0 1 1 1 1 
0 0 0 1 1 1 0 1 1 1 1 
0 0 0 1 1 1 1 1 1 1 0 
0 0 0 1 1 1 1 1 1 1 0 
0 0 0 1 1 1 1 1 1 1 0 
0 0 0 1 1 1 1 1 1 1 0 
0 0 0 1 1 1 1 1 1 1 0 
0 0 0 1 1 1 1 1 1 1 0 
0 0 0 1 1 1 1 1 1 1 0 
0 0 0 1 1 1 1 1 1 1 0 
0 0 0 1 1 1 1 1 1 1 0 

0 0 0 1 1 1 1 1 1 1 0 
0 0 0 1 0 0 0 0 0 1 0 
0 0 0 1 0 0 0 0 0 1 0 
0 0 0 1 0 0 0 0 0 1 0 
0 0 1 1 0 0 0 0 0 1 0 
0 0 0 1 0 0 0 0 0 1 0 
0 0 0 1 0 0 0 0 0 1 0 
0 0 0 1 1 1 1 1 1 1 0 
0 0 0 1 1 1 1 1 1 1 0 
0 0 0 0 0 0 0 0 1 1 0 
0 0 1 1 1 1 1 0 1 1 0 
0 0 0 1 1 1 0 0 1 1 0 
0 0 0 1 1 1 1 1 1 1 0 
0 0 0 1 1 1 1 1 1 1 0 
0 0 0 1 1 1 1 1 1 1 0 
0 0 0 1 1 1 1 1 1 1 0 

0 0 0 1 1 1 1 1 1 1 0 
0 0 0 1 0 0 0 0 0 1 0 
0 0 0 1 0 0 0 0 0 1 0 
0 0 0 1 0 0 0 0 0 1 0 
0 0 1 1 0 0 0 0 0 1 0 
0 0 0 1 0 0 0 0 0 1 0 
0 0 0 1 0 0 0 0 0 1 0 
0 0 0 1 1 1 1 1 1 1 0 
0 0 0 1 1 1 1 1 1 1 0 
0 0 0 1 1 1 1 1 1 1 0 
0 0 1 1 1 1 1 1 1 1 0 
0 0 0 1 1 1 0 1 1 1 0 
0 0 0 1 1 1 1 1 1 1 0 
0 0 0 1 1 0 0 0 1 1 0 
0 0 0 1 1 0 0 0 1 1 0 
0 0 0 1 2 10 2 10 2 1 0 

0 0 0 1 1 1 1 1 1 1 0 
0 0 0 1 0 0 0 0 0 1 0 
0 0 0 1 0 0 0 0 0 1 0 
0 0 0 1 0 0 0 0 0 1 0 
0 0 10 1 0 0 0 0 0 1 0 
0 0 0 1 0 0 0 0 0 1 0 
0 0 0 1 0 0 0 0 0 1 0 
0 0 0 1 0 1 0 0 0 1 0 
0 0 0 1 0 1 0 0 0 1 0 
0 0 0 1 0 1 0 0 0 1 0 
0 0 1 1 0 1 0 0 0 1 0 
0 0 0 1 0 1 0 0 0 1 0 
0 0 0 1 0 1 0 0 0 1 0 
0 0 0 1 0 1 0 0 0 1 0 
0 0 0 1 0 1 0 0 0 1 0 
0 0 0 1 2 2 2 2 2 1 0 

0 0 1 1 1 1 1 1 1 1 0 
0 0 1 1 0 0 0 0 0 1 0 
0 0 1 1 0 0 0 0 0 1 0 
0 0 1 1 0 0 0 0 0 1 0 
0 0 1 1 0 0 0 0 0 1 0 
0 0 0 1 0 0 0 0 0 1 0 
0 0 0 1 0 0 0 0 0 1 0 
0 0 0 1 0 0 0 1 0 1 0 
0 0 0 1 0 0 0 1 0 1 0 
0 0 0 1 0 0 0 1 0 1 0 
0 0 1 1 0 0 0 1 0 1 0 
0 0 0 1 0 0 0 1 0 1 0 
0 0 0 1 0 0 0 1 0 1 0 
0 0 0 1 0 0 0 1 0 1 0 
0 0 0 1 0 0 0 1 0 1 0 
0 0 0 1 2 2 2 2 2 1 0 

0 0 0 1 1 1 1 1 1 1 0 
0 0 0 1 0 0 0 0 0 1 0 
0 0 0 1 0 0 0 0 0 1 0 
0 0 0 1 0 0 0 0 0 1 0 
0 0 0 1 0 0 0 0 0 1 0 
0 0 0 1 0 0 0 0 0 1 0 
0 0 0 1 0 0 0 0 0 1 0 
0 0 0 1 0 1 0 0 0 1 0 
0 0 0 1 0 1 0 0 0 1 0 
0 0 0 1 0 1 0 0 0 1 0 
0 0 1 1 0 1 0 0 0 1 0 
0 0 0 1 0 1 0 0 0 1 0 
0 0 0 1 0 1 0 0 0 1 0 
0 0 0 1 0 1 0 0 0 1 0 
0 0 0 1 0 1 0 0 0 1 0 
0 0 0 1 2 2 2 2 2 1 0 

0 0 0 1 1 1 1 1 1 1 0 
0 0 0 1 0 0 0 0 0 1 0 
0 0 0 1 0 0 0 0 0 1 0 
0 0 0 1 0 0 0 0 0 1 0 
0 0 0 1 0 0 0 0 0 1 0 
0 0 0 1 0 0 0 0 0 1 0 
0 0 0 1 0 0 0 0 0 1 0 
0 0 0 1 0 0 0 0 0 1 0 
0 0 1 1 0 0 0 0 0 1 0 
0 0 0 1 0 0 0 1 0 1 0 
0 0 1 1 0 0 0 1 0 1 0 
0 0 0 1 0 0 0 1 0 1 0 
0 0 0 1 0 0 0 1 0 1 0 
0 0 0 1 0 0 0 1 0 1 0 
0 0 0 1 0 0 0 1 0 1 0 
0 0 0 1 2 2 2 2 2 1 0 

0 0 0 1 1 1 1 1 1 1 0 
0 0 0 1 0 0 0 0 0 1 0 
0 0 0 1 0 0 0 0 0 1 0 
0 0 0 1 0 0 0 0 0 1 0 
0 0 0 1 0 0 0 0 0 1 0 
0 0 0 1 0 0 0 0 0 1 0 
0 0 0 1 0 0 0 0 0 1 0 
0 0 0 1 0 0 0 0 0 1 0 
0 0 1 1 0 0 0 0 0 1 0 
0 0 0 1 0 0 0 0 0 1 0 
0 0 0 1 0 0 0 0 0 1 0 
0 0 0 1 0 1 0 0 0 1 0 
0 0 0 1 0 1 0 0 0 1 0 
0 0 0 1 0 1 0 0 0 1 0 
0 0 0 1 0 1 0 0 0 1 0 
0 0 0 1 2 2 2 2 2 1 0 

0 0 0 1 1 1 1 1 1 1 0 
0 0 0 1 0 0 0 0 0 1 0 
0 0 0 1 0 0 0 0 0 1 0 
0 0 0 1 0 0 0 0 0 1 0 
0 0 0 1 0 0 0 0 0 1 0 
0 0 0 1 0 0 0 0 0 1 0 
0 0 1 1 0 0 0 0 0 1 0 
0 0 0 1 0 0 0 0 0 1 0 
0 0 1 1 1 0 0 0 0 1 0 
0 0 0 1 0 0 0 0 0 1 0 
0 0 0 1 0 0 0 0 0 1 0 
0 0 0 1 0 0 0 0 0 1 0 
0 0 0 1 0 0 0 0 0 1 0 
0 0 0 1 0 0 0 1 0 1 0 
0 0 0 1 0 0 0 1 0 1 0 
0 0 0 1 2 2 2 2 2 1 0 

0 0 0 1 1 1 1 1 1 1 0 
0 0 0 1 0 0 0 0 0 1 0 
0 0 0 1 0 0 0 0 0 1 0 
0 0 0 1 0 0 0 0 0 1 0 
0 0 0 1 0 0 0 0 0 1 0 
0 0 0 1 0 0 0 0 0 1 0 
0 0 1 1 0 0 0 0 0 1 0 
0 0 0 1 0 0 0 0 0 1 0 
0 0 0 1 0 0 0 0 1 1 0 
0 0 0 1 0 0 0 0 0 1 0 
0 0 0 1 0 0 0 0 0 1 0 
0 0 0 1 0 0 0 0 0 1 0 
0 0 0 1 0 0 0 0 0 1 0 
0 0 0 1 0 0 0 0 0 1 0 
0 0 0 1 1 1 1 1 1 1 0 
0 0 0 1 1 1 1 1 1 1 0 

0 0 0 1 1 1 1 1 1 1 0 
0 0 0 1 0 0 0 0 0 1 0 
0 0 0 1 0 0 0 0 0 1 0 
0 0 0 1 0 0 0 0 0 1 0 
0 0 1 1 0 0 0 0 0 1 0 
0 0 0 1 0 0 0 0 0 1 0 
0 0 1 1 0 0 0 0 0 1 0 
0 0 0 1 0 0 0 0 0 1 0 
0 0 0 1 1 0 0 0 0 1 0 
0 0 0 1 0 0 0 0 0 1 0 
0 0 0 1 0 0 0 0 0 1 0 
0 0 0 1 0 0 0 0 0 1 0 
0 0 0 1 0 0 0 0 0 1 0 
0 0 0 1 0 0 0 0 0 1 0 
0 0 0 1 1 1 1 1 1 1 0 
0 0 0 1 1 1 1 1 1 1 0 

0 0 0 1 1 1 1 1 1 1 0 
0 0 0 1 0 0 0 0 0 1 0 
0 0 0 1 0 0 0 0 0 1 0 
0 0 0 1 0 0 0 0 0 1 0 
0 0 1 1 0 0 0 0 0 1 0 
0 0 0 1 0 0 0 0 0 1 0 
0 0 0 1 0 0 0 0 0 1 0 
0 0 0 1 0 0 0 0 0 1 0 
0 0 0 1 0 1 1 1 0 1 0 
0 0 0 1 0 1 1 1 0 1 0 
0 0 0 1 0 1 1 1 0 1 0 
0 0 0 1 0 1 0 1 0 1 0 
0 0 0 1 0 1 0 1 0 1 0 
0 0 0 1 0 1 0 1 0 1 0 
0 0 0 1 1 1 1 1 1 1 0 
0 0 0 1 1 1 1 1 1 1 0 

0 0 0 1 1 1 1 1 1 1 0 
0 0 0 1 0 0 0 0 0 1 0 
0 0 0 1 0 0 0 0 0 1 0 
0 0 0 0 0 0 0 0 0 1 0 
0 0 1 1 10 1 1 1 10 1 0 
0 0 0 1 0 0 0 0 0 1 0 
0 0 0 1 0 0 0 0 0 1 0 
0 0 0 1 0 0 0 0 0 1 0 
0 0 0 1 0 1 1 1 0 1 0 
0 0 0 1 0 1 0 0 0 1 0 
0 0 0 1 0 1 1 1 0 1 0 
0 0 0 1 0 1 0 1 0 1 0 
0 0 0 1 0 1 0 1 0 1 0 
0 0 0 1 0 1 10 1 0 1 0 
0 0 0 1 1 1 1 1 1 1 0 
0 0 0 1 1 1 1 1 1 1 0 

0 0 0 1 1 1 1 1 1 1 0 
0 0 0 1 0 0 0 0 0 1 0 
0 0 0 1 0 0 0 0 0 1 0 
0 0 0 1 0 0 0 0 0 1 0 
0 0 0 1 0 0 0 0 0 1 0 
0 0 0 1 0 0 0 0 0 1 0 
0 0 0 1 0 0 0 0 0 1 0 
0 0 0 1 0 0 0 0 0 1 0 
0 0 0 1 0 1 1 1 0 1 0 
0 0 0 1 0 1 1 1 0 1 0 
0 0 0 1 0 1 1 1 0 1 0 
0 0 0 1 0 1 0 1 0 1 0 
0 0 0 1 0 1 0 1 0 1 0 
0 0 0 1 0 1 0 1 0 1 0 
0 0 0 1 1 1 1 1 1 1 0 
0 0 0 1 1 1 1 1 1 1 0 

0 0 0 1 1 1 1 1 1 1 0 
0 0 0 1 0 0 0 0 0 1 0 
0 0 0 1 0 0 0 0 0 1 0 
0 0 0 1 0 0 0 0 0 1 0 
0 0 0 1 0 0 0 0 0 1 0 
0 0 0 1 0 0 0 0 0 1 0 
0 0 0 1 0 0 0 0 0 1 0 
0 0 0 1 0 0 0 0 0 1 0 
0 0 0 1 0 0 0 0 0 1 0 
0 0 0 1 0 0 0 0 0 1 0 
0 0 0 1 0 0 0 0 0 1 0 
0 0 0 1 0 0 0 0 0 1 0 
0 0 0 1 0 0 0 0 0 1 0 
0 0 0 1 0 0 0 0 0 1 0 
0 0 0 1 1 1 1 1 1 1 0 
0 0 0 1 1 1 1 1 1 1 0 

0 0 0 1 1 1 1 1 1 1 0 
0 0 0 1 1 1 1 1 1 1 0 
0 0 0 1 1 1 1 1 1 1 0 
0 0 0 1 1 1 1 1 1 1 0 
0 0 0 1 1 1 1 1 1 1 0 
0 0 0 1 1 1 1 1 1 1 0 
0 0 0 1 1 1 1 1 1 1 0 
0 0 0 1 1 1 1 1 1 1 0 
0 0 0 1 1 1 1 1 1 1 0 
0 0 0 1 1 1 1 1 1 1 0 
0 0 0 1 1 1 1 1 1 1 0 
0 0 0 1 1 1 1 1 1 1 0 
0 0 0 1 1 1 1 1 1 1 0 
0 0 0 1 1 1 1 1 1 1 0 
0 0 0 1 1 1 1 1 1 1 0 
0 0 0 1 1 1 1 1 1 1 0 

